NO    ./graphics/pictures/no.xpm
SO    ./graphics/pictures/so.xpm
WE    ./graphics/pictures/we.xpm
EA    ./graphics/pictures/ea.xpm


F 8,255,255
C 4,26,30



111111111111111
100000100000001
10000111111111111111111111
1000000000000000000110001
10000000000000000000010001
10000011000000000000000001
11111111001111111111110001
110000000000001      10001
1010010100E0001      10001
100000010000001      11011
10000001000000111111111111111111111
10000001000000000000000000000000001
11111111111111000111111111111111111
11111111111111000011111111111111111
101001010000001000000000000000000011111
110000110000001001100000000000110011011
111111111111111001100000000000110010001
              1000000000000000000010001
              1000000000000000000000001
              1000000000000000000000001
              1000000000000000000000001
              1000000000000000000000001
              1000000000000000000000001
              1000000000000000000000001
              1000000000000000000000001
              1000000000000000000000001
              1000000000000000000000001
              1000000000000000000000001
              1000000000000000000000001
              1000000000010000000000001
              1000000000000000000000001
              1000000000000000000000001
              1000000000000000000000001
              1000000000000000000000001
              1000000000000000000000001
              1000000000000000000000001
              1000000000000000000000001
              1000000000000000000000001
              1000000000000000000010001
              1000000000000000000010001
              1000000001000000000000001
              1000000000100000000000001
              1001100000000000110010001
              1001100000000000110010001
              1000000000000000000010001
              1000000000000000000010001
              1111111111111111111110001
                                  10001
                               11110001111
                               10000000001
   1111111111111               10000000001
   1000000000001               10000000001
   1000000000001               10000000001
   1000000000001               10000000001
   1000000000001               10100000101
   1000000000001               10001010001
   10011111111111111111111     11110011111
   10000000000000000000001       100001
   11110000000000000000001       100001
      10000000000000000001       100001
  1111100000000000011111111111111100001
  1000100000000000000000000000000000001
  1000000000000000000000000000000000001
  1000100000000000010000000000000000001
  1000111111111111110000000000000000001
  1000000010001    11111001111111111111
  1000000000101    100000000001
  1000000010001    100000000001
  1111011110001    100000000001
    10001 10101    100000000001
    10001110111    100000000001
    10000000001    100000000001
    11111100101    111111011111
         110001        10001
          10001        10001
           10001       10001
            10001      11111
             10001
              10001
               11111
